22222222222222222
20000000000000002
20000000000000002
20000000000000002
20000000000000002
20000001110000002
20000003330000002
11111113331111111
33333333333333333
33333333333333333