# Tileset
1 groundtop.png
2 wall.png
3 ground.png
4 purpleLadder_0.png
5 goldLadder_0.png
6 coral_0.png
7 walltop.png
# Tilelayout
200000000000000000000000000000000000000000000000000000000000000000000000000000000000000000000000000000000000000000000000000000000000000000000000000000000000000000000000000000000000000000000000000000000000000000000000000000000000000000000000000000000000000000000000000000000000000000000000000000000000000000000000000000000000000000000000000000000000000000002
200000000000000000000000000000000000000000000000000000000000000000000000000000000000000000000000000000000000000000000000000000000000000000000000000000000000000000000000000000000000000000000000000000000000000000000000000000000000000000000000000000000000000000000000000000000000000000000000000000000000000000000000000000000000000000000000000000000000000000002
200000000000000000000000000000000000777000000000000000000000777000000000000000000000007770000000000000000000000000000000000077700000000000000000000077700000000000000000000000777000000000000000000000000000000000007770000000000000000000007770000000000000000000000077700000000000000000000000000000000000777000000000000000000000777000000000000000000000007770002
200000000000000000000000000000000000222000000000000000000000222000000000000000000000002220000000000000000000000000000000000022200000000000000000000022200000000000000000000000222000000000000000000000000000000000002220000000000000000000002220000000000000000000000022200000000000000000000000000000000000222000000000000000000000222000000000000000000000002220002
200000000000000000000000000000777000222000000000000000777000222000000000000000007770002220000000000000000000000000000077700022200000000000000077700022200000000000000000777000222000000000000000000000000000007770002220000000000000007770002220000000000000000077700022200000000000000000000000000000777000222000000000000000777000222000000000000000007770002220002
200000000000000000000000000000222000000000000000000000222000000000000000000000002220000000000000000000000000000000000022200000000000000000000022200000000000000000000000222000000000000000000000000000000000002220000000000000000000002220000000000000000000000022200000000000000000000000000000000000222000000000000000000000222000000000000000000000002220000000002
200000000007770000000000777000222000000000000000777000222000000000000000007770002220000000000000000777000000000077700022200000000000000077700022200000000000000000777000222000000000000000077700000000007770002220000000000000007770002220000000000000000077700022200000000000000007770000000000777000222000000000000000777000222000000000000000007770002220000000002
200000000002220000000000222000000000000000000000222000000000000000000000002220000000000000000000000222000000000022200000000000000000000022200000000000000000000000222000000000000000000000022200000000002220000000000000000000002220000000000000000000000022200000000000000000000002220000000000222000000000000000000000222000000000000000000000002220000000000000002
111111111111111111111111111111111111111111111111111111111111111111111111111111111111111111111111111111111111111111111111111111111111111111111111111111111111111111111111111111111111111111111111111111111111111111111111111111111111111111111111111111111111111111111111111111111111111111111111111111111111111111111111111111111111111111111111111111111111111111111
333333333333333333333333333333333333333333333333333333333333333333333333333333333333333333333333333333333333333333333333333333333333333333333333333333333333333333333333333333333333333333333333333333333333333333333333333333333333333333333333333333333333333333333333333333333333333333333333333333333333333333333333333333333333333333333333333333333333333333333
# Backgrounds
parallax_mountain_pack/layers/parallax-mountain-bg.png 100000 100000000
parallax_mountain_pack/layers/parallax-mountain-mountain-far.png 10 100000000
parallax_mountain_pack/layers/parallax-mountain-trees.png 2 100000000